############################
#............##............#
#.####.#####.##.#####.####.#
#.####.#####.##.#####.####.#
#..........................#
#.####.##.########.##.#### #
#......##....##....##......#
######.#####.##.#####.######
'''''#.##..........##.#'''''
'''''#.##.###--###.##.#'''''
######.##.#''''''#.##.######
#.........#''''''#.........#
######.##.#''''''#.##.######
'''''#.##.########.##.#'''''
'''''#.##..........##.#'''''
######.##.########.##.######
#............##............#
#.####.#####.##.#####.####.#
#...##........}.......##...#
###.##.##.########.##.##.###
#......##....##....##......#
#.##########.##.##########.#
#..........................#
############################
