     ##############     
     #            #     
     #            #     
######            ######
  ~                    > 
######            ######
     #            #     
     #            #     
     ##############     